####################################################################################################################################################
#                                                                                                                                                  #
#    #######                                                                                                                                       #                                                                                                                                                  #
#                                                                                                                                                  #
#                                                                                                                                                  #
#                                                                                                                                                  #
#                                                                                                                                                  #
#                                                                                                                                                  #
#                                                                                                                                                  #
#                                                                                                                                                  #
#                                                                                                                                                  #
#                                                                                                                                                  #
#                                                                                                                                                  #                                                                                                                                                  #
#                                                                                                                                                  #
#                                                                                                                                                  #
#                                                                                                                                                  #
#                                                                                                                                                  #
#                                                                                                                                                  #
#                                                                                                                                                  #
#                                                                                                                                                  #
#                                                                                                                                                  #
#                                                                                                                                                  #
#                                                                                                                                                  #
#                                                                                                                                                  #
#                                                                                                                                                  #
################################################################################           #########################################################
#                                                                                                                                                  #
#                                                                                                                                                  #
#                                                                                                                                                  #
#                           ######                                                                                                                 #
#                                                                                                                                                  #
#                                                                                                                                                  #
#                                                                                                                                                  #
#   ################################################################################################################################################
#                                                                                                                                                  #
#                                                                                                                                                  #
#                                                                                                                                                  #
#                                                                                                                                                  #
#                                                                                                                                                  #
#                                                                                                                                                  #
#                                                                                                                                                  #
################################################################################################################################################   #
#                                                                                                                                                  #
#                                                                                                                                                  #
#                                                                                                                                                  #
#                                                                                                                                                  #
#                                                                                                                                                  #
#                                                                                                                                                  #
##############################################################################        #################################################################################################################################################################################################################
#                                                                                                                                                  #                                                                                                                                                  #
#                                                                                                                                                  #                                                                                                                                                  #
#                                                                                                                                                  #                                                                                                                                                  #
#                                                                                                                                                  #                                                                                                                                                  #
#                                                                                                                                                  #                                                                                                                                                  #
#                                                                                                                                                  #                                                                                                                                                  #
#                                                                                                                                                                                                                                                                                                     #
#                                                                                                                                                                                                                                                                                                     #
#                                                                                                                                                                                                                                                                                                     #
#############################################################################################################################################################################################################################      ####################################################################
